####################
#-------#-----#---##
#-##-##-#-#-#---#--#
#----#-------#-----#
#-##---##-##--#-##-#
#-#--#-#--#------#-#
#-#-##-#-##-#-##-#-#
#--------------#---#
#-##--###--###-#-#-#
#-##---#----#----#-#
#----#-######-#----#
#-##-#--------#-##-#
#--#---#-##-#---#--#
##-#-###-#--###-#-##
#--#-#---##---#-#--#
#-##---#----#---##-#
#----#-#-##-#-#----#
#--###-#----#-###--#
##-------##-------##
####################