####################
#------------------#
#-#-####-##-####-#-#
#-#-#----##----#-#-#
#-#-#-##----##-#-#-#
#-#---#--#--#----#-#

#---###-###-#-##---#

##----------------##

##-#-#-##--##-#-#-##
#--#-#-#----#-#-#--#
#-##-#-######-#-##-#
#----#---##---#----#

#-##---#-##-#---##-#

#-##-###----###-##-#

#------#-##---#----#

#-#--#---##-#----#-#

#-#--###----###--#-#

#-##-----##-----##-#

#----###----###----#

####################




























