####################
#---#-#---#-----#--#
#-#-#-#-#---###-#-##
#-#-----###--------#
#-##-##-----#####-##
#----#--###-#---#-##
#-#####-###-#-#----#
#--#-------------#-#
##---#-##--##-##-#-#
#--#-#-#----#-##-#-#
#-##-#-######-##-#-#
#-##----##---------#
#-----#----###-#-#-#
#-#####-#-##-----#-#
#---#---#----##-##-#
#-#-#-###-##-##----#
#-#---#---##-----#-#
#-#-#---#----###-#-#
#-----#---##-------#
####################