####################
#-----#-----##-----#
#-##--#-##---#-###-#
#-#--------#-----#-#
#-####--####--####-#
#---#--------------#
#-#-#-###-####-#-#-#
#------------------#
#-##-#-##--##-#-##-#
#----#-#----#-#----#
#-##-#-######-#-##-#
#----#--------#----#
#-#--#---##-#-#--#-#
#------#----#------#
#-#-####-#-#####-#-#
#-#-#----#-----#-#-#
#---#--######--#---#
#-###----#-----###-#
#------#----#------#
####################